page_loads,unique_visits,first_visits,returning_visits,Day,days_f
2146,1582,1430,152,Sunday,0
3621,2528,2297,231,Monday,1
3698,2630,2352,278,Tuesday,1
3667,2614,2327,287,Wednesday,1
3316,2366,2130,236,Thursday,1
2815,1863,1622,241,Friday,0
1658,1118,985,133,Saturday,0
2288,1656,1481,175,Sunday,0
3638,2586,2312,274,Monday,1
4462,3257,2989,268,Tuesday,1
4414,3175,2891,284,Wednesday,1
4315,3029,2743,286,Thursday,1
3323,2249,2033,216,Friday,0
1656,1180,1040,140,Saturday,0
2465,1806,1613,193,Sunday,0
4096,2873,2577,296,Monday,1
4474,3032,2720,312,Tuesday,1
4124,2849,2541,308,Wednesday,1
3514,2489,2239,250,Thursday,1
3005,2097,1856,241,Friday,0
2054,1436,1274,162,Saturday,0
2847,1913,1713,200,Sunday,0
4501,3181,2853,328,Monday,1
4603,3163,2804,359,Tuesday,1
4187,3014,2663,351,Wednesday,1
4343,2864,2545,319,Thursday,1
3565,2382,2100,282,Friday,0
2080,1457,1280,177,Saturday,0
3031,2089,1856,233,Sunday,0
4814,3339,2973,366,Monday,1
5040,3604,3217,387,Tuesday,1
5028,3515,3094,421,Wednesday,1
4658,3331,2955,376,Thursday,1
3624,2477,2148,329,Friday,0
2285,1619,1416,203,Saturday,0
3454,2346,2060,286,Sunday,0
5307,3717,3308,409,Monday,1
5135,3701,3280,421,Tuesday,1
5084,3611,3177,434,Wednesday,1
4650,3316,2940,376,Thursday,1
3571,2498,2170,328,Friday,0
2354,1661,1417,244,Saturday,0
3497,2508,2218,290,Sunday,0
5294,3737,3286,451,Monday,1
4643,3328,2905,423,Tuesday,1
4596,3279,2863,416,Wednesday,1
4162,3041,2657,384,Thursday,1
2933,2007,1728,279,Friday,0
2202,1496,1270,226,Saturday,0
3083,2204,1940,264,Sunday,0
4376,3057,2629,428,Monday,1
4704,3141,2739,402,Tuesday,1
4306,3200,2797,403,Wednesday,1
4178,3034,2627,407,Thursday,1
3236,2318,1975,343,Friday,0
2010,1536,1345,191,Saturday,0
2901,2141,1849,292,Sunday,0
4754,3325,2885,440,Monday,1
4417,3203,2793,410,Tuesday,1
4535,3351,2897,454,Wednesday,1
4274,3194,2758,436,Thursday,1
3382,2423,2061,362,Friday,0
2085,1488,1280,208,Saturday,0
3083,2215,1926,289,Sunday,0
4860,3559,3069,490,Monday,1
4893,3570,3133,437,Tuesday,1
4866,3544,3056,488,Wednesday,1
4584,3357,2899,458,Thursday,1
3914,2750,2361,389,Friday,0
2431,1716,1463,253,Saturday,0
3157,2369,2082,287,Sunday,0
5045,3615,3146,469,Monday,1
4746,3236,2821,415,Tuesday,1
4314,2919,2513,406,Wednesday,1
3663,2476,2162,314,Thursday,1
3270,2268,1931,337,Friday,0
2905,1976,1695,281,Saturday,0
4016,2832,2489,343,Sunday,0
5266,3877,3317,560,Monday,1
5795,4274,3700,574,Tuesday,1
5728,4217,3656,561,Wednesday,1
5293,3830,3295,535,Thursday,1
3934,2856,2479,377,Friday,0
3071,2165,1855,310,Saturday,0
3876,2984,2582,402,Sunday,0
5878,4375,3829,546,Monday,1
5712,4187,3635,552,Tuesday,1
5491,4074,3480,594,Wednesday,1
5144,3801,3247,554,Thursday,1
3880,2860,2418,442,Friday,0
2605,1838,1538,300,Saturday,0
3625,2650,2259,391,Sunday,0
4685,3478,3000,478,Monday,1
4891,3338,2861,477,Tuesday,1
4222,3053,2606,447,Wednesday,1
3691,2690,2275,415,Thursday,1
2748,1879,1559,320,Friday,0
1380,1011,836,175,Saturday,0
1474,1054,876,178,Sunday,0
2452,1715,1394,321,Monday,1
2298,1440,1159,281,Tuesday,1
1430,947,772,175,Wednesday,1
1002,667,522,145,Thursday,1
1486,1005,808,197,Friday,0
1345,941,781,160,Saturday,0
1453,948,765,183,Sunday,0
2173,1472,1228,244,Monday,1
2208,1424,1172,252,Tuesday,1
1381,955,773,182,Wednesday,1
1265,876,715,161,Thursday,1
1948,1288,1030,258,Friday,0
1742,1096,946,150,Saturday,0
1896,1409,1186,223,Sunday,0
3033,2062,1706,356,Monday,1
3445,2327,1942,385,Tuesday,1
3423,2384,1991,393,Wednesday,1
3319,2272,1922,350,Thursday,1
2783,1941,1663,278,Friday,0
1952,1240,1066,174,Saturday,0
2245,1611,1391,220,Sunday,0
3928,2518,2125,393,Monday,1
3810,2621,2239,382,Tuesday,1
3931,2656,2229,427,Wednesday,1
3523,2457,2069,388,Thursday,1
2943,1928,1640,288,Friday,0
1751,1237,1052,185,Saturday,0
2491,1762,1541,221,Sunday,0
3766,2665,2271,394,Monday,1
4194,2852,2423,429,Tuesday,1
4038,2916,2482,434,Wednesday,1
3891,2702,2334,368,Thursday,1
3111,2181,1897,284,Friday,0
1946,1414,1239,175,Saturday,0
2802,2010,1740,270,Sunday,0
3892,2841,2466,375,Monday,1
4172,3003,2592,411,Tuesday,1
4464,3280,2862,418,Wednesday,1
4377,3143,2679,464,Thursday,1
3734,2514,2129,385,Friday,0
2262,1657,1443,214,Saturday,0
3050,2122,1825,297,Sunday,0
4794,3366,2867,499,Monday,1
4936,3423,2922,501,Tuesday,1
5016,3500,3023,477,Wednesday,1
4489,3170,2753,417,Thursday,1
3505,2468,2075,393,Friday,0
2264,1679,1437,242,Saturday,0
3314,2435,2100,335,Sunday,0
5095,3619,3125,494,Monday,1
5525,3793,3272,521,Tuesday,1
5074,3689,3190,499,Wednesday,1
4571,3319,2810,509,Thursday,1
3570,2664,2253,411,Friday,0
2182,1565,1323,242,Saturday,0
3265,2277,1935,342,Sunday,0
4670,3297,2826,471,Monday,1
4764,3452,2957,495,Tuesday,1
4943,3526,3026,500,Wednesday,1
4790,3307,2811,496,Thursday,1
3604,2621,2241,380,Friday,0
2455,1823,1569,254,Saturday,0
3650,2690,2329,361,Sunday,0
5463,3975,3433,542,Monday,1
5884,4112,3542,570,Tuesday,1
5615,4019,3432,587,Wednesday,1
5289,3747,3186,561,Thursday,1
4434,2969,2486,483,Friday,0
2665,1977,1694,283,Saturday,0
3907,2906,2519,387,Sunday,0
5308,3778,3222,556,Monday,1
5773,4025,3490,535,Tuesday,1
5585,4060,3457,603,Wednesday,1
4783,3582,3049,533,Thursday,1
3893,2707,2259,448,Friday,0
2917,2048,1723,325,Saturday,0
3353,2468,2104,364,Sunday,0
5400,3824,3246,578,Monday,1
5395,3926,3350,576,Tuesday,1
5229,3859,3263,596,Wednesday,1
5371,3784,3204,580,Thursday,1
4185,3045,2559,486,Friday,0
2724,1988,1675,313,Saturday,0
3590,2620,2196,424,Sunday,0
5367,3771,3192,579,Monday,1
5440,3968,3387,581,Tuesday,1
5465,4043,3458,585,Wednesday,1
5318,3813,3262,551,Thursday,1
4225,2916,2462,454,Friday,0
2687,1975,1667,308,Saturday,0
3791,2786,2388,398,Sunday,0
5661,3949,3331,618,Monday,1
5759,4081,3487,594,Tuesday,1
5599,3983,3378,605,Wednesday,1
5103,3755,3184,571,Thursday,1
4313,2946,2446,500,Friday,0
2971,2011,1651,360,Saturday,0
3662,2693,2285,408,Sunday,0
5635,3985,3386,599,Monday,1
5581,3963,3359,604,Tuesday,1
5329,3761,3170,591,Wednesday,1
4553,3214,2710,504,Thursday,1
3423,2404,1988,416,Friday,0
2708,1807,1512,295,Saturday,0
3306,2266,1895,371,Sunday,0
5203,3692,3133,559,Monday,1
5712,4104,3456,648,Tuesday,1
5601,4015,3401,614,Wednesday,1
5486,4063,3430,633,Thursday,1
4178,3213,2697,516,Friday,0
2878,2153,1835,318,Saturday,0
4169,2903,2447,456,Sunday,0
6372,4485,3787,698,Monday,1
6240,4391,3698,693,Tuesday,1
6170,4409,3723,686,Wednesday,1
6071,4275,3586,689,Thursday,1
4682,3307,2741,566,Friday,0
3208,2291,1894,397,Saturday,0
4310,3144,2669,475,Sunday,0
6435,4694,3929,765,Monday,1
6299,4455,3769,686,Tuesday,1
6360,4512,3797,715,Wednesday,1
6349,4360,3664,696,Thursday,1
4660,3387,2845,542,Friday,0
3354,2420,2035,385,Saturday,0
4371,3189,2688,501,Sunday,0
6534,4731,3977,754,Monday,1
6832,4941,4161,780,Tuesday,1
6689,4870,4110,760,Wednesday,1
5849,4086,3450,636,Thursday,1
4247,3064,2562,502,Friday,0
3219,2360,1958,402,Saturday,0
4211,3210,2765,445,Sunday,0
6424,4752,4043,709,Monday,1
6223,4520,3818,702,Tuesday,1
6551,4768,4059,709,Wednesday,1
6343,4449,3770,679,Thursday,1
4696,3366,2824,542,Friday,0
3134,2239,1846,393,Saturday,0
3868,2844,2365,479,Sunday,0
6020,4482,3787,695,Monday,1
5705,4160,3490,670,Tuesday,1
5752,4016,3348,668,Wednesday,1
5181,3605,3008,597,Thursday,1
4269,2913,2404,509,Friday,0
2633,1818,1473,345,Saturday,0
3336,2376,1988,388,Sunday,0
5127,3587,2955,632,Monday,1
5449,3767,3149,618,Tuesday,1
5746,3956,3371,585,Wednesday,1
5115,3642,3046,596,Thursday,1
3995,2749,2243,506,Friday,0
2618,1884,1585,299,Saturday,0
2961,2117,1763,354,Sunday,0
4090,2913,2427,486,Monday,1
5201,3637,3073,564,Tuesday,1
5321,3797,3146,651,Wednesday,1
5219,3509,2887,622,Thursday,1
4017,2804,2338,466,Friday,0
2297,1629,1346,283,Saturday,0
3145,2226,1860,366,Sunday,0
4905,3419,2797,622,Monday,1
4747,3284,2701,583,Tuesday,1
4591,3317,2713,604,Wednesday,1
4431,3173,2652,521,Thursday,1
3608,2523,2068,455,Friday,0
2422,1673,1336,337,Saturday,0
3132,2145,1790,355,Sunday,0
4962,3377,2788,589,Monday,1
4881,3469,2862,607,Tuesday,1
5001,3425,2786,639,Wednesday,1
4635,3242,2614,628,Thursday,1
3545,2494,2066,428,Friday,0
2262,1490,1235,255,Saturday,0
2866,2034,1692,342,Sunday,0
4692,3261,2682,579,Monday,1
4602,3204,2660,544,Tuesday,1
4620,3101,2556,545,Wednesday,1
4475,2955,2386,569,Thursday,1
3564,2422,1954,468,Friday,0
2071,1370,1129,241,Saturday,0
2659,1840,1523,317,Sunday,0
4338,2963,2410,553,Monday,1
4531,3139,2566,573,Tuesday,1
4498,3022,2481,541,Wednesday,1
4128,2730,2210,520,Thursday,1
3132,2153,1721,432,Friday,0
1829,1264,1067,197,Saturday,0
2149,1517,1224,293,Sunday,0
3975,2691,2169,522,Monday,1
4046,2718,2180,538,Tuesday,1
3897,2745,2266,479,Wednesday,1
3871,2540,2072,468,Thursday,1
2630,1716,1353,363,Friday,0
1602,1104,900,204,Saturday,0
1960,1370,1141,229,Sunday,0
4143,2655,2171,484,Monday,1
4205,2789,2266,523,Tuesday,1
4193,2783,2255,528,Wednesday,1
3710,2536,2069,467,Thursday,1
3137,2203,1767,436,Friday,0
1834,1145,944,201,Saturday,0
2070,1473,1197,276,Sunday,0
4180,2852,2310,542,Monday,1
4038,2731,2226,505,Tuesday,1
3906,2667,2119,548,Wednesday,1
3580,2424,1940,484,Thursday,1
2948,2070,1708,362,Friday,0
1622,1121,924,197,Saturday,0
2179,1480,1214,266,Sunday,0
3906,2615,2146,469,Monday,1
3745,2596,2071,525,Tuesday,1
4212,2761,2205,556,Wednesday,1
3901,2595,2095,500,Thursday,1
3292,2207,1785,422,Friday,0
1819,1229,1016,213,Saturday,0
2068,1562,1286,276,Sunday,0
3991,2805,2243,562,Monday,1
4073,2862,2361,501,Tuesday,1
4069,2825,2324,501,Wednesday,1
3716,2629,2126,503,Thursday,1
3380,2120,1709,411,Friday,0
1737,1197,958,239,Saturday,0
2181,1567,1282,285,Sunday,0
3973,2794,2263,531,Monday,1
3997,2794,2269,525,Tuesday,1
4132,2798,2287,511,Wednesday,1
3791,2693,2204,489,Thursday,1
2968,2139,1738,401,Friday,0
1752,1266,1021,245,Saturday,0
2070,1497,1231,266,Sunday,0
3920,2684,2139,545,Monday,1
4106,2791,2266,525,Tuesday,1
4006,2726,2166,560,Wednesday,1
3827,2639,2133,506,Thursday,1
2944,1973,1564,409,Friday,0
1827,1193,954,239,Saturday,0
2373,1658,1369,289,Sunday,0
4031,2763,2290,473,Monday,1
4027,2780,2248,532,Tuesday,1
3912,2795,2291,504,Wednesday,1
3867,2715,2191,524,Thursday,1
3304,2238,1806,432,Friday,0
1685,1208,1011,197,Saturday,0
2130,1542,1282,260,Sunday,0
3936,2697,2182,515,Monday,1
4029,2744,2203,541,Tuesday,1
4010,2789,2237,552,Wednesday,1
4027,2890,2392,498,Thursday,1
2829,2000,1585,415,Friday,0
1736,1227,1023,204,Saturday,0
2517,1686,1416,270,Sunday,0
4029,2769,2299,470,Monday,1
4261,2890,2358,532,Tuesday,1
4058,2923,2442,481,Wednesday,1
4392,3007,2466,541,Thursday,1
3072,2221,1846,375,Friday,0
1799,1284,1068,216,Saturday,0
2341,1611,1345,266,Sunday,0
3330,2354,1963,391,Monday,1
4734,3381,2833,548,Tuesday,1
4801,3381,2845,536,Wednesday,1
4399,3079,2575,504,Thursday,1
3275,2375,1958,417,Friday,0
2042,1429,1223,206,Saturday,0
2827,2103,1844,259,Sunday,0
4836,3437,2954,483,Monday,1
4840,3465,2944,521,Tuesday,1
4504,3356,2902,454,Wednesday,1
4379,3240,2736,504,Thursday,1
3391,2428,2024,404,Friday,0
2045,1513,1278,235,Saturday,0
2721,2081,1817,264,Sunday,0
4630,3535,2998,537,Monday,1
4748,3540,3004,536,Tuesday,1
4702,3377,2893,484,Wednesday,1
4440,3309,2827,482,Thursday,1
3513,2518,2116,402,Friday,0
2253,1633,1395,238,Saturday,0
3141,2291,1980,311,Sunday,0
5122,3808,3289,519,Monday,1
5151,3868,3305,563,Tuesday,1
4969,3703,3182,521,Wednesday,1
4619,3365,2876,489,Thursday,1
3443,2598,2196,402,Friday,0
2302,1754,1503,251,Saturday,0
3291,2506,2173,333,Sunday,0
5206,3737,3170,567,Monday,1
5474,3940,3337,603,Tuesday,1
5400,3934,3350,584,Wednesday,1
5334,3821,3244,577,Thursday,1
4174,3022,2547,475,Friday,0
2571,1853,1597,256,Saturday,0
3572,2636,2283,353,Sunday,0
5018,3788,3241,547,Monday,1
5565,4159,3536,623,Tuesday,1
5420,4048,3403,645,Wednesday,1
5366,3908,3331,577,Thursday,1
4091,3002,2507,495,Friday,0
2824,2087,1770,317,Saturday,0
3843,2825,2441,384,Sunday,0
5516,4140,3491,649,Monday,1
5572,4121,3460,661,Tuesday,1
5243,3882,3298,584,Wednesday,1
5133,3720,3104,616,Thursday,1
4084,2947,2441,506,Friday,0
2739,1978,1647,331,Saturday,0
3781,2857,2435,422,Sunday,0
5684,4073,3417,656,Monday,1
5687,4179,3534,645,Tuesday,1
5906,4266,3614,652,Wednesday,1
5541,4020,3368,652,Thursday,1
4171,3043,2501,542,Friday,0
2586,1820,1496,324,Saturday,0
3838,2922,2456,466,Sunday,0
5675,4076,3419,657,Monday,1
5624,4178,3504,674,Tuesday,1
5794,4316,3670,646,Wednesday,1
5389,4031,3379,652,Thursday,1
4305,3047,2522,525,Friday,0
3281,2202,1854,348,Saturday,0
3790,2837,2418,419,Sunday,0
5894,4203,3487,716,Monday,1
5461,4048,3388,660,Tuesday,1
5206,3869,3219,650,Wednesday,1
5228,3929,3281,648,Thursday,1
4097,2971,2436,535,Friday,0
2694,1964,1616,348,Saturday,0
3893,2930,2483,447,Sunday,0
6185,4550,3872,678,Monday,1
6178,4503,3795,708,Tuesday,1
6067,4397,3693,704,Wednesday,1
5656,4166,3487,679,Thursday,1
4398,3173,2645,528,Friday,0
2836,2086,1741,345,Saturday,0
3896,2927,2424,503,Sunday,0
5814,4236,3543,693,Monday,1
5879,4140,3475,665,Tuesday,1
4800,3457,2836,621,Wednesday,1
3838,2825,2334,491,Thursday,1
3576,2579,2118,461,Friday,0
2799,1974,1652,322,Saturday,0
4228,3127,2605,522,Sunday,0
6331,4570,3817,753,Monday,1
6380,4743,4027,716,Tuesday,1
6314,4829,4039,790,Wednesday,1
6160,4584,3835,749,Thursday,1
4859,3615,2995,620,Friday,0
3317,2468,2040,428,Saturday,0
4715,3550,2972,578,Sunday,0
6940,5136,4303,833,Monday,1
6551,4866,4068,798,Tuesday,1
6327,4761,3961,800,Wednesday,1
6212,4578,3830,748,Thursday,1
4687,3388,2771,617,Friday,0
3014,2283,1856,427,Saturday,0
4132,3064,2548,516,Sunday,0
5989,4330,3606,724,Monday,1
5331,3967,3309,658,Tuesday,1
5183,3665,3025,640,Wednesday,1
4769,3515,2917,598,Thursday,1
3627,2518,2071,447,Friday,0
1857,1319,1087,232,Saturday,0
2221,1489,1204,285,Sunday,0
3335,2335,1906,429,Monday,1
2883,2047,1639,408,Tuesday,1
2353,1621,1312,309,Wednesday,1
1578,1099,886,213,Thursday,1
1017,724,586,138,Friday,0
1334,936,760,176,Saturday,0
1690,1155,947,208,Sunday,0
2838,1829,1474,355,Monday,1
2815,1786,1419,367,Tuesday,1
2382,1618,1292,326,Wednesday,1
1587,1035,809,226,Thursday,1
1411,960,786,174,Friday,0
1838,1197,969,228,Saturday,0
2180,1562,1279,283,Sunday,0
3587,2494,2037,457,Monday,1
3855,2742,2230,512,Tuesday,1
3840,2628,2127,501,Wednesday,1
3735,2746,2258,488,Thursday,1
3223,2286,1860,426,Friday,0
2207,1531,1280,251,Saturday,0
2814,2000,1661,339,Sunday,0
4007,2976,2444,532,Monday,1
4119,2961,2385,576,Tuesday,1
4338,3164,2631,533,Wednesday,1
4432,2962,2418,544,Thursday,1
3306,2349,1866,483,Friday,0
2223,1557,1262,295,Saturday,0
2757,2002,1635,367,Sunday,0
4047,2898,2373,525,Monday,1
4489,3190,2566,624,Tuesday,1
4588,3232,2656,576,Wednesday,1
4398,3106,2561,545,Thursday,1
3340,2455,1990,465,Friday,0
2344,1639,1338,301,Saturday,0
2973,2094,1736,358,Sunday,0
4638,3205,2649,556,Monday,1
4791,3409,2834,575,Tuesday,1
5104,3768,3197,571,Wednesday,1
4621,3439,2876,563,Thursday,1
3831,2715,2232,483,Friday,0
2295,1690,1400,290,Saturday,0
3235,2462,2050,412,Sunday,0
4918,3640,3060,580,Monday,1
5127,3783,3195,588,Tuesday,1
4794,3575,2999,576,Wednesday,1
4788,3420,2848,572,Thursday,1
3948,2727,2256,471,Friday,0
2383,1765,1477,288,Saturday,0
2950,2231,1839,392,Sunday,0
4905,3592,3024,568,Monday,1
5353,3931,3299,632,Tuesday,1
5492,4007,3358,649,Wednesday,1
5052,3628,3019,609,Thursday,1
3764,2807,2300,507,Friday,0
2458,1788,1459,329,Saturday,0
3098,2277,1866,411,Sunday,0
4951,3652,3039,613,Monday,1
5495,4000,3304,696,Tuesday,1
5505,4062,3375,687,Wednesday,1
5188,3812,3156,656,Thursday,1
4002,2932,2377,555,Friday,0
2607,1888,1537,351,Saturday,0
3906,2838,2355,483,Sunday,0
6360,4432,3684,748,Monday,1
6046,4460,3714,746,Tuesday,1
5938,4309,3499,810,Wednesday,1
5325,3892,3199,693,Thursday,1
4165,3048,2490,558,Friday,0
2829,2096,1726,370,Saturday,0
4090,2979,2462,517,Sunday,0
5734,4224,3493,731,Monday,1
6214,4474,3731,743,Tuesday,1
5906,4333,3597,736,Wednesday,1
5814,4191,3419,772,Thursday,1
4507,3188,2624,564,Friday,0
2859,2064,1718,346,Saturday,0
3897,2806,2326,480,Sunday,0
5849,4240,3503,737,Monday,1
6264,4526,3743,783,Tuesday,1
6062,4404,3624,780,Wednesday,1
5685,4159,3415,744,Thursday,1
4391,3241,2627,614,Friday,0
2880,2046,1638,408,Saturday,0
3740,2673,2163,510,Sunday,0
5710,4261,3469,792,Monday,1
5168,3778,3047,731,Tuesday,1
5577,4062,3287,775,Wednesday,1
5238,3827,3134,693,Thursday,1
3931,2871,2320,551,Friday,0
2606,1892,1568,324,Saturday,0
3149,2410,2028,382,Sunday,0
5565,3968,3274,694,Monday,1
5281,3770,3035,735,Tuesday,1
5202,3780,3146,634,Wednesday,1
4581,3203,2649,554,Thursday,1
3264,2281,1847,434,Friday,0
2344,1759,1393,366,Saturday,0
3112,2311,1890,421,Sunday,0
5051,3655,2985,670,Monday,1
5333,3944,3217,727,Tuesday,1
5671,4078,3369,709,Wednesday,1
5097,3707,3026,681,Thursday,1
4555,2971,2408,563,Friday,0
2987,2129,1737,392,Saturday,0
4257,2964,2421,543,Sunday,0
5804,4216,3426,790,Monday,1
5885,4379,3597,782,Tuesday,1
6054,4293,3522,771,Wednesday,1
5791,4147,3422,725,Thursday,1
4741,3430,2820,610,Friday,0
2946,2140,1740,400,Saturday,0
4071,2864,2330,534,Sunday,0
6265,4503,3667,836,Monday,1
6298,4626,3769,857,Tuesday,1
6495,4628,3791,837,Wednesday,1
5536,4189,3431,758,Thursday,1
4737,3447,2785,662,Friday,0
3232,2333,1862,471,Saturday,0
4201,3093,2504,589,Sunday,0
6806,4769,3920,849,Monday,1
6769,4817,3940,877,Tuesday,1
6581,4824,3926,898,Wednesday,1
6254,4537,3707,830,Thursday,1
5163,3685,3009,676,Friday,0
3851,2595,2113,482,Saturday,0
4695,3386,2761,625,Sunday,0
7098,5224,4237,987,Monday,1
7156,5392,4468,924,Tuesday,1
6836,5056,4130,926,Wednesday,1
6329,4724,3892,832,Thursday,1
4990,3608,2922,686,Friday,0
3536,2489,1993,496,Saturday,0
4366,3236,2605,631,Sunday,0
6510,4786,3909,877,Monday,1
6855,4962,4085,877,Tuesday,1
6599,4651,3744,907,Wednesday,1
5510,4105,3375,730,Thursday,1
4549,3245,2639,606,Friday,0
3064,2167,1760,407,Saturday,0
3633,2663,2180,483,Sunday,0
5838,4283,3489,794,Monday,1
6026,4336,3581,755,Tuesday,1
5780,4226,3479,747,Wednesday,1
5131,3781,3101,680,Thursday,1
3928,2845,2294,551,Friday,0
2636,1930,1552,378,Saturday,0
3278,2366,1922,444,Sunday,0
4785,3560,2882,678,Monday,1
4886,3601,2914,687,Tuesday,1
5145,3672,2987,685,Wednesday,1
5849,4211,3484,727,Thursday,1
4456,3324,2725,599,Friday,0
2960,2138,1716,422,Saturday,0
3885,2860,2338,522,Sunday,0
5857,4155,3368,787,Monday,1
6162,4345,3526,819,Tuesday,1
6014,4254,3398,856,Wednesday,1
5652,4119,3385,734,Thursday,1
4793,3340,2692,648,Friday,0
2819,1995,1611,384,Saturday,0
3687,2546,2067,479,Sunday,0
4851,3399,2701,698,Monday,1
5775,4216,3413,803,Tuesday,1
5443,3962,3193,769,Wednesday,1
5590,3959,3176,783,Thursday,1
4482,3164,2489,675,Friday,0
2792,1947,1533,414,Saturday,0
3371,2449,1979,470,Sunday,0
5547,3832,3036,796,Monday,1
5468,3954,3226,728,Tuesday,1
5104,3751,3064,687,Wednesday,1
4728,3485,2812,673,Thursday,1
4024,2855,2290,565,Friday,0
2350,1677,1348,329,Saturday,0
3234,2196,1779,417,Sunday,0
4948,3550,2790,760,Monday,1
5247,3760,3052,708,Tuesday,1
5003,3557,2810,747,Wednesday,1
4816,3482,2775,707,Thursday,1
4208,2818,2267,551,Friday,0
2454,1668,1357,311,Saturday,0
2763,1919,1506,413,Sunday,0
4954,3522,2829,693,Monday,1
4903,3470,2793,677,Tuesday,1
4907,3464,2772,692,Wednesday,1
4625,3336,2669,667,Thursday,1
3497,2482,1947,535,Friday,0
1826,1358,1101,257,Saturday,0
2307,1721,1356,365,Sunday,0
4368,3078,2433,645,Monday,1
4233,3091,2466,625,Tuesday,1
4187,2948,2377,571,Wednesday,1
3811,2726,2135,591,Thursday,1
3179,2226,1730,496,Friday,0
1615,1039,814,225,Saturday,0
1788,1307,1028,279,Sunday,0
2959,2144,1653,491,Monday,1
3947,2840,2235,605,Tuesday,1
3841,2821,2248,573,Wednesday,1
3729,2700,2148,552,Thursday,1
3324,2381,1891,490,Friday,0
1795,1305,1036,269,Saturday,0
2373,1655,1321,334,Sunday,0
4101,2855,2208,647,Monday,1
4241,2960,2352,608,Tuesday,1
4478,3189,2578,611,Wednesday,1
3961,2814,2214,600,Thursday,1
3367,2325,1796,529,Friday,0
1828,1222,951,271,Saturday,0
2344,1636,1319,317,Sunday,0
4415,3007,2382,625,Monday,1
4403,3151,2502,649,Tuesday,1
4244,3082,2450,632,Wednesday,1
4322,3077,2404,673,Thursday,1
3456,2431,1936,495,Friday,0
2068,1407,1099,308,Saturday,0
2568,1755,1374,381,Sunday,0
4770,3320,2628,692,Monday,1
4621,3277,2595,682,Tuesday,1
4470,3164,2513,651,Wednesday,1
4307,3077,2459,618,Thursday,1
3370,2366,1818,548,Friday,0
1960,1341,1017,324,Saturday,0
2412,1765,1423,342,Sunday,0
4504,3095,2489,606,Monday,1
4382,3138,2499,639,Tuesday,1
4710,3369,2697,672,Wednesday,1
4324,3106,2479,627,Thursday,1
3472,2497,1980,517,Friday,0
1909,1339,1081,258,Saturday,0
2365,1688,1334,354,Sunday,0
4460,3056,2438,618,Monday,1
4479,3135,2482,653,Tuesday,1
4510,3207,2550,657,Wednesday,1
4340,3111,2491,620,Thursday,1
3508,2436,1933,503,Friday,0
2030,1420,1122,298,Saturday,0
2586,1749,1399,350,Sunday,0
4476,2970,2346,624,Monday,1
3232,2299,1823,476,Tuesday,1
4291,3106,2498,608,Wednesday,1
4247,2926,2327,599,Thursday,1
3477,2539,2045,494,Friday,0
2169,1470,1169,301,Saturday,0
2430,1808,1453,355,Sunday,0
4358,3082,2439,643,Monday,1
4465,3249,2550,699,Tuesday,1
4550,3210,2615,595,Wednesday,1
4147,3011,2380,631,Thursday,1
3634,2532,2000,532,Friday,0
2014,1430,1141,289,Saturday,0
2687,1910,1555,355,Sunday,0
4376,3115,2521,594,Monday,1
4318,3226,2622,604,Tuesday,1
4441,3219,2620,599,Wednesday,1
4234,3116,2556,560,Thursday,1
3027,2230,1762,468,Friday,0
1966,1376,1101,275,Saturday,0
2446,1761,1452,309,Sunday,0
3779,2643,2145,498,Monday,1
4619,3341,2727,614,Tuesday,1
4983,3584,2925,659,Wednesday,1
4645,3319,2716,603,Thursday,1
3612,2630,2139,491,Friday,0
2153,1577,1323,254,Saturday,0
3089,2307,1978,329,Sunday,0
4580,3446,2882,564,Monday,1
4788,3625,2992,633,Tuesday,1
5095,3759,3113,646,Wednesday,1
4668,3454,2860,594,Thursday,1
3711,2785,2272,513,Friday,0
2523,1861,1577,284,Saturday,0
3364,2547,2122,425,Sunday,0
5513,4050,3321,729,Monday,1
5362,3762,3095,667,Tuesday,1
5402,3987,3293,694,Wednesday,1
5398,3996,3299,697,Thursday,1
3783,2663,2134,529,Friday,0
2395,1797,1503,294,Saturday,0
3679,2719,2289,430,Sunday,0
5688,4325,3570,755,Monday,1
5842,4382,3645,737,Tuesday,1
5923,4458,3682,776,Wednesday,1
5717,4222,3487,735,Thursday,1
4250,3176,2565,611,Friday,0
2525,1986,1656,330,Saturday,0
3923,3023,2559,464,Sunday,0
5785,4281,3545,736,Monday,1
6052,4522,3780,742,Tuesday,1
6150,4588,3814,774,Wednesday,1
5591,4134,3419,715,Thursday,1
4279,3196,2616,580,Friday,0
2897,2066,1717,349,Saturday,0
3904,2873,2374,499,Sunday,0
5458,4145,3442,703,Monday,1
5909,4399,3685,714,Tuesday,1
6175,4620,3823,797,Wednesday,1
5856,4422,3581,841,Thursday,1
4610,3505,2837,668,Friday,0
3081,2269,1864,405,Saturday,0
4390,3265,2718,547,Sunday,0
6507,4917,4018,899,Monday,1
6941,5103,4189,914,Tuesday,1
6576,4776,3961,815,Wednesday,1
5985,4462,3701,761,Thursday,1
4789,3497,2840,657,Friday,0
3263,2292,1881,411,Saturday,0
4180,3135,2561,574,Sunday,0
6371,4865,3993,872,Monday,1
6648,4960,4070,890,Tuesday,1
6501,4777,3880,897,Wednesday,1
6088,4431,3574,857,Thursday,1
4376,3179,2510,669,Friday,0
2733,1955,1549,406,Saturday,0
3953,2921,2344,577,Sunday,0
6108,4416,3563,853,Monday,1
5668,4185,3360,825,Tuesday,1
6159,4508,3663,845,Wednesday,1
5810,4241,3426,815,Thursday,1
4491,3394,2670,724,Friday,0
3110,2263,1842,421,Saturday,0
4418,3281,2713,568,Sunday,0
6529,4488,3573,915,Monday,1
5756,4251,3437,814,Tuesday,1
5716,4102,3315,787,Wednesday,1
5323,4022,3246,776,Thursday,1
4280,3085,2441,644,Friday,0
2982,2169,1777,392,Saturday,0
4365,3172,2595,577,Sunday,0
6627,4888,3942,946,Monday,1
6467,4808,3905,903,Tuesday,1
6631,4903,3984,919,Wednesday,1
6378,4681,3779,902,Thursday,1
4767,3424,2734,690,Friday,0
3501,2580,2136,444,Saturday,0
4647,3426,2777,649,Sunday,0
6336,4693,3788,905,Monday,1
6222,4564,3646,918,Tuesday,1
5527,3904,3082,822,Wednesday,1
4267,3197,2561,636,Thursday,1
3733,2678,2135,543,Friday,0
3299,2394,1907,487,Saturday,0
4530,3396,2722,674,Sunday,0
6908,5047,4167,880,Monday,1
7714,5338,4369,969,Tuesday,1
7490,5425,4389,1036,Wednesday,1
7190,5081,4120,961,Thursday,1
5391,3977,3171,806,Friday,0
3575,2667,2178,489,Saturday,0
5285,4031,3247,784,Sunday,0
7330,5439,4452,987,Monday,1
7489,5479,4500,979,Tuesday,1
7345,5467,4469,998,Wednesday,1
6679,4991,3998,993,Thursday,1
5403,3970,3190,780,Friday,0
3573,2712,2203,509,Saturday,0
4834,3515,2838,677,Sunday,0
6905,4945,3988,957,Monday,1
6743,4927,3942,985,Tuesday,1
6201,4488,3593,895,Wednesday,1
5571,4071,3229,842,Thursday,1
3872,2780,2191,589,Friday,0
2613,1884,1480,404,Saturday,0
3109,2293,1853,440,Sunday,0
4324,3145,2477,668,Monday,1
4226,3064,2339,725,Tuesday,1
3991,2914,2278,636,Wednesday,1
3160,2211,1728,483,Thursday,1
2386,1626,1257,369,Friday,0
1115,825,634,191,Saturday,0
1387,930,740,190,Sunday,0
2147,1418,1142,276,Monday,1
2686,1777,1349,428,Tuesday,1
2885,1915,1476,439,Wednesday,1
2694,1837,1400,437,Thursday,1
2273,1541,1164,377,Friday,0
1188,836,643,193,Saturday,0
1447,1039,832,207,Sunday,0
2568,1844,1448,396,Monday,1
3566,2527,1970,557,Tuesday,1
3941,2816,2226,590,Wednesday,1
3841,2625,2058,567,Thursday,1
3261,2338,1812,526,Friday,0
2241,1523,1204,319,Saturday,0
2679,1892,1519,373,Sunday,0
4182,2841,2191,650,Monday,1
4236,3039,2391,648,Tuesday,1
4628,3206,2536,670,Wednesday,1
4205,3025,2403,622,Thursday,1
3459,2508,2033,475,Friday,0
2448,1744,1390,354,Saturday,0
2853,2015,1586,429,Sunday,0
4638,3178,2543,635,Monday,1
5325,3669,2942,727,Tuesday,1
4866,3364,2670,694,Wednesday,1
4715,3375,2689,686,Thursday,1
3753,2713,2136,577,Friday,0
2481,1778,1437,341,Saturday,0
3233,2401,1981,420,Sunday,0
5034,3660,2957,703,Monday,1
4787,3593,2909,684,Tuesday,1
4901,3602,2923,679,Wednesday,1
4398,3266,2653,613,Thursday,1
3823,2832,2267,565,Friday,0
2619,1901,1534,367,Saturday,0
3518,2612,2205,407,Sunday,0
5178,3826,3127,699,Monday,1
5290,3876,3127,749,Tuesday,1
5469,4116,3402,714,Wednesday,1
5399,4028,3303,725,Thursday,1
4232,3012,2342,670,Friday,0
2828,2084,1697,387,Saturday,0
3724,2783,2281,502,Sunday,0
5733,4249,3448,801,Monday,1
5814,4284,3521,763,Tuesday,1
5349,4006,3248,758,Wednesday,1
5025,3681,3010,671,Thursday,1
4044,2922,2335,587,Friday,0
2323,1731,1377,354,Saturday,0
3147,2469,2005,464,Sunday,0
4972,3719,3014,705,Monday,1
4878,3582,2897,685,Tuesday,1
5288,3786,3039,747,Wednesday,1
4968,3668,2934,734,Thursday,1
3788,2748,2158,590,Friday,0
2514,1839,1496,343,Saturday,0
3463,2602,2083,519,Sunday,0
4931,3700,3009,691,Monday,1
5101,3873,3079,794,Tuesday,1
5144,3727,2998,729,Wednesday,1
4433,3372,2657,715,Thursday,1
3597,2648,2111,537,Friday,0
2621,1826,1482,344,Saturday,0
3397,2494,2021,473,Sunday,0
5062,3812,3009,803,Monday,1
4926,3678,2933,745,Tuesday,1
4936,3558,2822,736,Wednesday,1
4688,3441,2747,694,Thursday,1
3827,2699,2140,559,Friday,0
2452,1754,1408,346,Saturday,0
3283,2394,1958,436,Sunday,0
4823,3481,2764,717,Monday,1
4821,3662,2942,720,Tuesday,1
5059,3613,2923,690,Wednesday,1
4585,3444,2744,700,Thursday,1
3682,2733,2178,555,Friday,0
2350,1714,1351,363,Saturday,0
3056,2189,1755,434,Sunday,0
4746,3367,2721,646,Monday,1
4613,3465,2808,657,Tuesday,1
4560,3441,2694,747,Wednesday,1
4520,3304,2629,675,Thursday,1
3346,2433,1930,503,Friday,0
2253,1649,1325,324,Saturday,0
2927,2267,1807,460,Sunday,0
4878,3463,2799,664,Monday,1
4852,3481,2802,679,Tuesday,1
4585,3430,2757,673,Wednesday,1
4477,3260,2600,660,Thursday,1
3654,2566,1993,573,Friday,0
2411,1760,1420,340,Saturday,0
3054,2336,1882,454,Sunday,0
4696,3479,2765,714,Monday,1
5033,3633,2875,758,Tuesday,1
4948,3530,2809,721,Wednesday,1
4636,3390,2704,686,Thursday,1
3539,2636,2060,576,Friday,0
2371,1678,1338,340,Saturday,0
2816,2159,1715,444,Sunday,0
4493,3356,2672,684,Monday,1
4678,3486,2739,747,Tuesday,1
4737,3484,2762,722,Wednesday,1
4775,3514,2806,708,Thursday,1
3658,2725,2181,544,Friday,0
2260,1664,1324,340,Saturday,0
3343,2433,1933,500,Sunday,0
4640,3440,2756,684,Monday,1
4694,3532,2867,665,Tuesday,1
4771,3517,2800,717,Wednesday,1
4173,3017,2395,622,Thursday,1
3046,2238,1752,486,Friday,0
2260,1701,1333,368,Saturday,0
2876,2143,1700,443,Sunday,0
4774,3402,2719,683,Monday,1
5009,3702,2906,796,Tuesday,1
5369,3852,3133,719,Wednesday,1
5020,3669,2969,700,Thursday,1
3935,2802,2203,599,Friday,0
2795,2049,1630,419,Saturday,0
3795,2827,2305,522,Sunday,0
5489,4083,3252,831,Monday,1
5680,4108,3336,772,Tuesday,1
5383,3940,3205,735,Wednesday,1
4890,3695,2985,710,Thursday,1
3872,2887,2310,577,Friday,0
2790,1987,1602,385,Saturday,0
3524,2616,2118,498,Sunday,0
4903,3551,2875,676,Monday,1
5160,3802,3079,723,Tuesday,1
5194,3766,2995,771,Wednesday,1
5142,3755,3013,742,Thursday,1
3836,2925,2323,602,Friday,0
2737,1981,1572,409,Saturday,0
3386,2534,2025,509,Sunday,0
4816,3585,2900,685,Monday,1
4734,3458,2763,695,Tuesday,1
4761,3475,2754,721,Wednesday,1
4277,3224,2570,654,Thursday,1
3563,2620,2056,564,Friday,0
2401,1749,1379,370,Saturday,0
2877,2126,1674,452,Sunday,0
4448,3191,2494,697,Monday,1
4525,3226,2593,633,Tuesday,1
4533,3318,2676,642,Wednesday,1
4431,3307,2686,621,Thursday,1
3456,2470,1938,532,Friday,0
2162,1651,1332,319,Saturday,0
2786,1971,1597,374,Sunday,0
4172,3041,2403,638,Monday,1
4255,3077,2457,620,Tuesday,1
4154,2996,2400,596,Wednesday,1
3803,2839,2263,576,Thursday,1
2950,2183,1720,463,Friday,0
1909,1444,1155,289,Saturday,0
2506,1781,1399,382,Sunday,0
3325,2457,1913,544,Monday,1
4086,2909,2298,611,Tuesday,1
3716,2667,2069,598,Wednesday,1
3702,2639,2103,536,Thursday,1
2959,2171,1680,491,Friday,0
2006,1471,1161,310,Saturday,0
2479,1795,1419,376,Sunday,0
3501,2610,2072,538,Monday,1
3985,2922,2361,561,Tuesday,1
3920,2913,2314,599,Wednesday,1
3868,2796,2209,587,Thursday,1
2921,2101,1660,441,Friday,0
1655,1244,975,269,Saturday,0
2229,1622,1299,323,Sunday,0
3660,2598,2020,578,Monday,1
3898,2809,2202,607,Tuesday,1
3912,2797,2200,597,Wednesday,1
3604,2624,2029,595,Thursday,1
2970,2105,1621,484,Friday,0
1546,1187,957,230,Saturday,0
1944,1465,1146,319,Sunday,0
3608,2493,1959,534,Monday,1
3514,2472,1905,567,Tuesday,1
3344,2475,1915,560,Wednesday,1
3292,2351,1824,527,Thursday,1
2469,1850,1445,405,Friday,0
1296,925,702,223,Saturday,0
1546,1071,811,260,Sunday,0
2948,1998,1528,470,Monday,1
3077,2190,1690,500,Tuesday,1
3028,2145,1649,496,Wednesday,1
2738,1976,1474,502,Thursday,1
2147,1478,1087,391,Friday,0
1277,903,675,228,Saturday,0
1606,1142,879,263,Sunday,0
2504,1726,1296,430,Monday,1
2218,1566,1217,349,Tuesday,1
3024,2149,1681,468,Wednesday,1
2951,2047,1555,492,Thursday,1
2401,1693,1310,383,Friday,0
1242,891,700,191,Saturday,0
1511,1172,938,234,Sunday,0
2934,2062,1619,443,Monday,1
3003,2140,1663,477,Tuesday,1
3073,2192,1710,482,Wednesday,1
2933,2043,1550,493,Thursday,1
2468,1710,1287,423,Friday,0
1355,892,689,203,Saturday,0
1553,1122,891,231,Sunday,0
2902,1954,1479,475,Monday,1
2899,2109,1591,518,Tuesday,1
2986,2032,1584,448,Wednesday,1
2964,2031,1571,460,Thursday,1
2433,1609,1214,395,Friday,0
1280,923,725,198,Saturday,0
1603,1170,909,261,Sunday,0
3154,2214,1726,488,Monday,1
3084,2148,1666,482,Tuesday,1
2983,1925,1490,435,Wednesday,1
2849,1908,1440,468,Thursday,1
2420,1538,1150,388,Friday,0
1300,895,712,183,Saturday,0
1526,1112,863,249,Sunday,0
2872,1978,1481,497,Monday,1
2914,1957,1463,494,Tuesday,1
2843,1994,1536,458,Wednesday,1
2649,1894,1447,447,Thursday,1
2042,1478,1150,328,Friday,0
1225,901,681,220,Saturday,0
1562,1045,792,253,Sunday,0
2751,1823,1398,425,Monday,1
2634,1868,1415,453,Tuesday,1
2704,1961,1511,450,Wednesday,1
2670,1864,1463,401,Thursday,1
2073,1498,1121,377,Friday,0
1240,888,669,219,Saturday,0
1530,1076,811,265,Sunday,0
2392,1704,1346,358,Monday,1
2675,1846,1471,375,Tuesday,1
2755,1911,1436,475,Wednesday,1
2608,1824,1421,403,Thursday,1
2163,1521,1163,358,Friday,0
1304,951,743,208,Saturday,0
1969,1419,1156,263,Sunday,0
2985,2069,1575,494,Monday,1
3087,2259,1772,487,Tuesday,1
3047,2147,1704,443,Wednesday,1
2961,2026,1600,426,Thursday,1
2293,1589,1257,332,Friday,0
1261,934,751,183,Saturday,0
1676,1211,983,228,Sunday,0
1786,1287,1005,282,Monday,1
3252,2310,1845,465,Tuesday,1
3082,2179,1741,438,Wednesday,1
2721,1963,1579,384,Thursday,1
2217,1583,1235,348,Friday,0
1271,908,730,178,Saturday,0
1742,1197,958,239,Sunday,0
2293,1704,1380,324,Monday,1
3155,2289,1818,471,Tuesday,1
3159,2320,1882,438,Wednesday,1
3054,2243,1777,466,Thursday,1
2440,1848,1488,360,Friday,0
1532,1108,924,184,Saturday,0
2247,1657,1366,291,Sunday,0
3570,2496,2033,463,Monday,1
3524,2540,2075,465,Tuesday,1
3471,2473,2040,433,Wednesday,1
3303,2415,1974,441,Thursday,1
2560,1867,1519,348,Friday,0
1470,1090,912,178,Saturday,0
2234,1715,1446,269,Sunday,0
3504,2596,2123,473,Monday,1
3984,2840,2382,458,Tuesday,1
3746,2660,2188,472,Wednesday,1
3524,2667,2143,524,Thursday,1
2639,1944,1591,353,Friday,0
1523,1178,975,203,Saturday,0
2425,1809,1521,288,Sunday,0
3671,2705,2202,503,Monday,1
3669,2780,2306,474,Tuesday,1
3537,2657,2211,446,Wednesday,1
3413,2507,2048,459,Thursday,1
2699,1902,1554,348,Friday,0
1829,1289,1058,231,Saturday,0
2379,1812,1507,305,Sunday,0
3637,2669,2221,448,Monday,1
3775,2787,2253,534,Tuesday,1
3572,2731,2245,486,Wednesday,1
3605,2695,2230,465,Thursday,1
2774,2078,1670,408,Friday,0
1780,1354,1106,248,Saturday,0
2469,1884,1571,313,Sunday,0
3881,2869,2348,521,Monday,1
3767,2785,2296,489,Tuesday,1
4082,2924,2335,589,Wednesday,1
4047,2768,2240,528,Thursday,1
2877,2114,1706,408,Friday,0
2073,1559,1298,261,Saturday,0
2759,2066,1739,327,Sunday,0
3817,2880,2344,536,Monday,1
3949,2930,2402,528,Tuesday,1
3867,2896,2395,501,Wednesday,1
3621,2582,2119,463,Thursday,1
2978,2220,1772,448,Friday,0
1992,1434,1158,276,Saturday,0
2851,2142,1779,363,Sunday,0
4390,3177,2651,526,Monday,1
3886,2938,2406,532,Tuesday,1
3424,2477,2017,460,Wednesday,1
4207,3087,2561,526,Thursday,1
3345,2478,1984,494,Friday,0
2128,1567,1277,290,Saturday,0
2205,1637,1319,318,Sunday,0
4091,2999,2453,546,Monday,1
4223,3143,2555,588,Tuesday,1
4361,3147,2554,593,Wednesday,1
4263,3103,2513,590,Thursday,1
3341,2397,1903,494,Friday,0
2278,1634,1307,327,Saturday,0
3097,2299,1888,411,Sunday,0
4185,3113,2538,575,Monday,1
4477,3341,2689,652,Tuesday,1
4354,3227,2579,648,Wednesday,1
4194,3005,2401,604,Thursday,1
3240,2319,1833,486,Friday,0
2424,1613,1283,330,Saturday,0
3168,2309,1853,456,Sunday,0
4709,3433,2784,649,Monday,1
4634,3373,2727,646,Tuesday,1
4545,3345,2681,664,Wednesday,1
4532,3332,2693,639,Thursday,1
3317,2508,2018,490,Friday,0
2449,1741,1386,355,Saturday,0
2893,2231,1780,451,Sunday,0
4170,3135,2555,580,Monday,1
4277,3026,2419,607,Tuesday,1
3588,2625,2078,547,Wednesday,1
3141,2237,1760,477,Thursday,1
2658,1843,1429,414,Friday,0
2391,1652,1327,325,Saturday,0
3202,2354,1901,453,Sunday,0
4349,3251,2601,650,Monday,1
4886,3660,2968,692,Tuesday,1
4555,3484,2824,660,Wednesday,1
4477,3134,2530,604,Thursday,1
3577,2603,2056,547,Friday,0
2430,1827,1461,366,Saturday,0
3449,2504,2006,498,Sunday,0
4955,3673,3019,654,Monday,1
4475,3435,2775,660,Tuesday,1
4595,3452,2766,686,Wednesday,1
4451,3199,2563,636,Thursday,1
3418,2549,2037,512,Friday,0
2605,1944,1572,372,Saturday,0
3483,2607,2102,505,Sunday,0
4651,3350,2656,694,Monday,1
4029,3011,2351,660,Tuesday,1
4282,3205,2609,596,Wednesday,1
4138,2930,2315,615,Thursday,1
4130,2803,2211,592,Friday,0
2581,1761,1429,332,Saturday,0
3355,2300,1876,424,Sunday,0
4482,3109,2491,618,Monday,1
4584,3021,2456,565,Tuesday,1
4106,2661,2133,528,Wednesday,1
3378,2243,1798,445,Thursday,1
2446,1544,1211,333,Friday,0
1447,958,753,205,Saturday,0
1326,895,696,199,Sunday,0
1609,1015,809,206,Monday,1
2481,1438,1105,333,Tuesday,1
2798,1740,1350,390,Wednesday,1
2809,1797,1425,372,Thursday,1
2216,1410,1083,327,Friday,0
1546,1071,839,232,Saturday,0
1339,923,724,199,Sunday,0
1709,1120,878,242,Monday,1
3389,2208,1755,453,Tuesday,1
3391,2282,1827,455,Wednesday,1
3698,2310,1878,432,Thursday,1
3511,2272,1801,471,Friday,0
2279,1498,1196,302,Saturday,0
2822,1869,1495,374,Sunday,0
4240,2784,2186,598,Monday,1
4319,2844,2302,542,Tuesday,1
4224,2866,2304,562,Wednesday,1
3797,2704,2203,501,Thursday,1
3190,2127,1692,435,Friday,0
1998,1373,1128,245,Saturday,0
2515,1711,1393,318,Sunday,0
3950,2612,2065,547,Monday,1
4033,2631,2133,498,Tuesday,1
4269,2812,2285,527,Wednesday,1
4124,2677,2157,520,Thursday,1
3228,2198,1763,435,Friday,0
2287,1423,1160,263,Saturday,0
2946,1996,1628,368,Sunday,0
4608,3035,2534,501,Monday,1
4786,3154,2566,588,Tuesday,1
4724,3244,2680,564,Wednesday,1
4417,2875,2348,527,Thursday,1
3580,2314,1825,489,Friday,0
2345,1544,1229,315,Saturday,0
3170,2140,1776,364,Sunday,0
4862,3194,2573,621,Monday,1
4600,3106,2504,602,Tuesday,1
4705,3249,2704,545,Wednesday,1
4723,3164,2571,593,Thursday,1
3969,2572,2104,468,Friday,0
2994,2034,1702,332,Saturday,0
3162,2186,1811,375,Sunday,0
4949,3287,2735,552,Monday,1
5092,3465,2838,627,Tuesday,1
4767,3319,2729,590,Wednesday,1
4625,3179,2603,576,Thursday,1
3738,2477,2015,462,Friday,0
2739,1793,1477,316,Saturday,0
3923,2476,2077,399,Sunday,0
5341,3687,3045,642,Monday,1
5114,3460,2836,624,Tuesday,1
4896,3214,2568,646,Wednesday,1
4502,3050,2507,543,Thursday,1
3729,2518,2012,506,Friday,0
2388,1618,1319,299,Saturday,0
3405,2314,1928,386,Sunday,0
5176,3620,2971,649,Monday,1
5429,3597,2978,619,Tuesday,1
5120,3448,2869,579,Wednesday,1
4993,3379,2774,605,Thursday,1
4148,2751,2221,530,Friday,0
2763,1981,1648,333,Saturday,0
3599,2446,2011,435,Sunday,0
5542,3728,3052,676,Monday,1
5378,3764,3123,641,Tuesday,1
5536,3734,3095,639,Wednesday,1
4984,3315,2713,602,Thursday,1
4130,2754,2231,523,Friday,0
2818,1922,1579,343,Saturday,0
3978,2699,2249,450,Sunday,0
5502,3727,3019,708,Monday,1
5740,3842,3160,682,Tuesday,1
5635,3734,3037,697,Wednesday,1
5375,3704,3044,660,Thursday,1
4273,3038,2490,548,Friday,0
3223,2305,1918,387,Saturday,0
3956,2727,2288,439,Sunday,0
5895,4141,3447,694,Monday,1
6152,4207,3398,809,Tuesday,1
5906,4021,3305,716,Wednesday,1
6300,4061,3279,782,Thursday,1
4915,3259,2673,586,Friday,0
3218,2161,1818,343,Saturday,0
4429,2919,2435,484,Sunday,0
5739,4038,3316,722,Monday,1
6220,4292,3553,739,Tuesday,1
6238,4163,3396,767,Wednesday,1
6226,4251,3595,656,Thursday,1
4364,2994,2457,537,Friday,0
2882,2021,1682,339,Saturday,0
4010,2748,2263,485,Sunday,0
6084,3995,3289,706,Monday,1
5874,4147,3446,701,Tuesday,1
5719,3917,3288,629,Wednesday,1
5003,3396,2812,584,Thursday,1
3605,2541,2062,479,Friday,0
2811,1901,1512,389,Saturday,0
3567,2438,1956,482,Sunday,0
5237,3542,2875,667,Monday,1
6154,4126,3438,688,Tuesday,1
5895,4112,3418,694,Wednesday,1
5858,3943,3232,711,Thursday,1
5034,3348,2749,599,Friday,0
3613,2291,1840,451,Saturday,0
4389,3059,2530,529,Sunday,0
6278,4290,3546,744,Monday,1
6836,4514,3747,767,Tuesday,1
6731,4596,3759,837,Wednesday,1
6287,4332,3563,769,Thursday,1
5089,3454,2850,604,Friday,0
3812,2542,2094,448,Saturday,0
5290,3538,2914,624,Sunday,0
7161,4993,4188,805,Monday,1
7352,4939,4058,881,Tuesday,1
7218,4842,4001,841,Wednesday,1
7040,4672,3895,777,Thursday,1
5367,3728,3029,699,Friday,0
4021,2749,2253,496,Saturday,0
5397,3722,3059,663,Sunday,0
7605,5124,4216,908,Monday,1
7614,5094,4181,913,Tuesday,1
7984,5541,4616,925,Wednesday,1
7040,4823,3957,866,Thursday,1
5628,3749,3095,654,Friday,0
3926,2618,2141,477,Saturday,0
5479,3635,3057,578,Sunday,0
6670,4584,3784,800,Monday,1
6783,4542,3742,800,Tuesday,1
7105,4865,4013,852,Wednesday,1
6877,4702,3854,848,Thursday,1
5460,3711,3039,672,Friday,0
3648,2568,2058,510,Saturday,0
4917,3311,2737,574,Sunday,0
6980,4654,3881,773,Monday,1
6702,4577,3700,877,Tuesday,1
6699,4488,3581,907,Wednesday,1
6001,4059,3265,794,Thursday,1
5094,3454,2766,688,Friday,0
3179,2237,1821,416,Saturday,0
4169,2912,2413,499,Sunday,0
6392,4388,3637,751,Monday,1
5878,4094,3384,710,Tuesday,1
5800,3976,3266,710,Wednesday,1
5690,4023,3254,769,Thursday,1
4314,2986,2400,586,Friday,0
2948,2117,1735,382,Saturday,0
3864,2674,2155,519,Sunday,0
5499,3708,3005,703,Monday,1
5790,4040,3269,771,Tuesday,1
5720,3971,3206,765,Wednesday,1
5692,3675,2965,710,Thursday,1
4082,2803,2188,615,Friday,0
2716,1965,1597,368,Saturday,0
3430,2374,1887,487,Sunday,0
4353,2994,2392,602,Monday,1
5525,3777,3112,665,Tuesday,1
5407,3574,2908,666,Wednesday,1
4994,3485,2792,693,Thursday,1
3835,2681,2172,509,Friday,0
2511,1750,1423,327,Saturday,0
3371,2308,1891,417,Sunday,0
5226,3399,2741,658,Monday,1
5139,3453,2811,642,Tuesday,1
5051,3474,2828,646,Wednesday,1
4787,3283,2685,598,Thursday,1
3956,2670,2107,563,Friday,0
2303,1589,1278,311,Saturday,0
3011,2091,1717,374,Sunday,0
4896,3326,2714,612,Monday,1
4952,3309,2624,685,Tuesday,1
4570,3099,2439,660,Wednesday,1
4542,2962,2377,585,Thursday,1
3383,2320,1847,473,Friday,0
1922,1316,1061,255,Saturday,0
2404,1677,1361,316,Sunday,0
4576,2964,2313,651,Monday,1
4727,3144,2519,625,Tuesday,1
4639,2989,2370,619,Wednesday,1
4108,2762,2154,608,Thursday,1
3372,2207,1744,463,Friday,0
1996,1277,989,288,Saturday,0
2415,1619,1266,353,Sunday,0
4457,2881,2272,609,Monday,1
4736,3039,2410,629,Tuesday,1
4245,2818,2244,574,Wednesday,1
4081,2785,2160,625,Thursday,1
3053,2008,1568,440,Friday,0
1741,1147,927,220,Saturday,0
2186,1447,1140,307,Sunday,0
4026,2533,1952,581,Monday,1
3961,2515,1966,549,Tuesday,1
3019,2032,1595,437,Wednesday,1
3743,2496,1997,499,Thursday,1
3050,1995,1575,420,Friday,0
1688,1080,857,223,Saturday,0
2185,1440,1145,295,Sunday,0
4104,2576,2016,560,Monday,1
4097,2694,2059,635,Tuesday,1
3844,2506,1895,611,Wednesday,1
3743,2530,2001,529,Thursday,1
3073,2068,1581,487,Friday,0
1852,1249,992,257,Saturday,0
2105,1474,1173,301,Sunday,0
4078,2657,2095,562,Monday,1
4515,2856,2255,601,Tuesday,1
4276,2779,2173,606,Wednesday,1
4043,2705,2114,591,Thursday,1
3004,2028,1576,452,Friday,0
1664,1177,942,235,Saturday,0
2248,1561,1246,315,Sunday,0
4062,2658,2081,577,Monday,1
4053,2680,2091,589,Tuesday,1
3628,2431,1879,552,Wednesday,1
3596,2415,1925,490,Thursday,1
3140,2002,1539,463,Friday,0
1938,1304,1054,250,Saturday,0
2460,1699,1364,335,Sunday,0
4175,2771,2166,605,Monday,1
4113,2881,2310,571,Tuesday,1
4273,2901,2310,591,Wednesday,1
4194,2754,2202,552,Thursday,1
3405,2345,1833,512,Friday,0
1800,1251,1025,226,Saturday,0
2378,1694,1388,306,Sunday,0
4319,2856,2233,623,Monday,1
4388,2971,2375,596,Tuesday,1
4205,2724,2118,606,Wednesday,1
3973,2555,1998,557,Thursday,1
3510,2224,1777,447,Friday,0
1913,1281,1012,269,Saturday,0
2397,1644,1284,360,Sunday,0
4348,2789,2224,565,Monday,1
3966,2688,2127,561,Tuesday,1
3805,2544,2035,509,Wednesday,1
3866,2604,2074,530,Thursday,1
3489,2219,1737,482,Friday,0
2074,1394,1108,286,Saturday,0
2519,1687,1318,369,Sunday,0
4202,2734,2128,606,Monday,1
4023,2711,2147,564,Tuesday,1
4048,2685,2121,564,Wednesday,1
4150,2860,2249,611,Thursday,1
3154,2199,1742,457,Friday,0
2143,1317,1012,305,Saturday,0
2576,1705,1372,333,Sunday,0
4317,2954,2367,587,Monday,1
4421,3023,2427,596,Tuesday,1
4563,3019,2395,624,Wednesday,1
4055,2798,2265,533,Thursday,1
3427,2305,1815,490,Friday,0
1731,1241,989,252,Saturday,0
2258,1641,1293,348,Sunday,0
3655,2499,2032,467,Monday,1
4456,2995,2435,560,Tuesday,1
4566,3042,2456,586,Wednesday,1
4314,3049,2508,541,Thursday,1
3557,2349,1890,459,Friday,0
2281,1548,1255,293,Saturday,0
3346,2255,1906,349,Sunday,0
4711,3200,2600,600,Monday,1
4709,3134,2595,539,Tuesday,1
4379,3032,2464,568,Wednesday,1
4357,2870,2325,545,Thursday,1
3560,2396,1907,489,Friday,0
2049,1488,1244,244,Saturday,0
2813,1934,1614,320,Sunday,0
5064,3241,2621,620,Monday,1
5006,3221,2595,626,Tuesday,1
4949,3282,2708,574,Wednesday,1
4695,3165,2573,592,Thursday,1
3516,2383,1933,450,Friday,0
2460,1704,1374,330,Saturday,0
2994,2127,1733,394,Sunday,0
4688,3273,2679,594,Monday,1
4924,3481,2885,596,Tuesday,1
5209,3546,2936,610,Wednesday,1
5966,4029,3385,644,Thursday,1
4740,3171,2643,528,Friday,0
2715,1870,1618,252,Saturday,0
3739,2573,2194,379,Sunday,0
5841,3982,3331,651,Monday,1
5881,4096,3514,582,Tuesday,1
5540,3863,3249,614,Wednesday,1
5636,3894,3306,588,Thursday,1
4479,3120,2638,482,Friday,0
3076,2094,1750,344,Saturday,0
3973,2865,2457,408,Sunday,0
6045,4310,3659,651,Monday,1
6126,4173,3522,651,Tuesday,1
6084,4319,3616,703,Wednesday,1
6154,4254,3632,622,Thursday,1
4868,3385,2784,601,Friday,0
3409,2379,2006,373,Saturday,0
4722,3357,2859,498,Sunday,0
6555,4550,3766,784,Monday,1
7079,4652,3893,759,Tuesday,1
6691,4673,3893,780,Wednesday,1
6522,4398,3666,732,Thursday,1
4922,3390,2857,533,Friday,0
3409,2399,1990,409,Saturday,0
4483,3092,2623,469,Sunday,0
6666,4499,3769,730,Monday,1
6991,4677,3916,761,Tuesday,1
6871,4619,3808,811,Wednesday,1
6357,4331,3579,752,Thursday,1
5114,3468,2827,641,Friday,0
3456,2400,2006,394,Saturday,0
4924,3251,2735,516,Sunday,0
6837,4704,3890,814,Monday,1
6481,4547,3798,749,Tuesday,1
6296,4316,3545,771,Wednesday,1
6044,3988,3299,689,Thursday,1
4860,3326,2738,588,Friday,0
3430,2289,1946,343,Saturday,0
4638,3236,2744,492,Sunday,0
6365,4329,3609,720,Monday,1
6330,4291,3556,735,Tuesday,1
5865,3937,3267,670,Wednesday,1
5692,3938,3298,640,Thursday,1
5026,3533,2917,616,Friday,0
3506,2428,2018,410,Saturday,0
4778,3265,2709,556,Sunday,0
6684,4592,3795,797,Monday,1
6766,4720,3918,802,Tuesday,1
6916,4674,3872,802,Wednesday,1
6440,4379,3634,745,Thursday,1
5066,3497,2863,634,Friday,0
3503,2489,2043,446,Saturday,0
4855,3321,2691,630,Sunday,0
6818,4601,3795,806,Monday,1
6239,4424,3640,784,Tuesday,1
5471,3904,3194,710,Wednesday,1
4453,3186,2592,594,Thursday,1
4062,2892,2347,545,Friday,0
3485,2445,1987,458,Saturday,0
4906,3371,2815,556,Sunday,0
7099,4871,4012,859,Monday,1
7503,5181,4267,914,Tuesday,1
7554,5227,4330,897,Wednesday,1
7169,4944,4106,838,Thursday,1
5608,3895,3211,684,Friday,0
4055,2800,2306,494,Saturday,0
5611,3906,3259,647,Sunday,0
7650,5378,4431,947,Monday,1
7372,5225,4328,897,Tuesday,1
7369,5166,4316,850,Wednesday,1
7250,5093,4213,880,Thursday,1
5735,4032,3296,736,Friday,0
4614,3240,2699,541,Saturday,0
5979,4062,3352,710,Sunday,0
7840,5421,4465,956,Monday,1
7659,5267,4330,937,Tuesday,1
7319,4983,4010,973,Wednesday,1
6373,4452,3620,832,Thursday,1
4897,3404,2776,628,Friday,0
3325,2209,1833,376,Saturday,0
3874,2671,2206,465,Sunday,0
5436,3791,3062,729,Monday,1
5174,3562,2945,617,Tuesday,1
4873,3255,2632,623,Wednesday,1
3913,2716,2164,552,Thursday,1
2934,1979,1543,436,Friday,0
1523,1074,846,228,Saturday,0
1859,1223,997,226,Sunday,0
1835,1310,1019,291,Monday,1
1852,1214,955,259,Tuesday,1
2357,1594,1243,351,Wednesday,1
2583,1783,1418,365,Thursday,1
2477,1613,1279,334,Friday,0
1694,1197,990,207,Saturday,0
1985,1340,1097,243,Sunday,0
1723,1159,874,285,Monday,1
1715,1168,891,277,Tuesday,1
3431,2361,1899,462,Wednesday,1
4118,2793,2259,534,Thursday,1
3504,2373,1936,437,Friday,0
2308,1609,1348,261,Saturday,0
2925,2046,1648,398,Sunday,0
4587,3100,2550,550,Monday,1
4731,3182,2585,597,Tuesday,1
4831,3245,2660,585,Wednesday,1
4162,2836,2298,538,Thursday,1
3726,2476,1999,477,Friday,0
2458,1722,1413,309,Saturday,0
3266,2264,1878,386,Sunday,0
5016,3348,2760,588,Monday,1
4732,3320,2738,582,Tuesday,1
4938,3447,2845,602,Wednesday,1
5033,3516,2967,549,Thursday,1
4114,2731,2236,495,Friday,0
2780,1929,1599,330,Saturday,0
4205,2367,1974,393,Sunday,0
4983,3391,2783,608,Monday,1
5182,3674,3052,622,Tuesday,1
5316,3856,3199,657,Wednesday,1
5021,3462,2853,609,Thursday,1
4230,2882,2382,500,Friday,0
2743,1882,1541,341,Saturday,0
3890,2622,2232,390,Sunday,0
5575,3925,3232,693,Monday,1
5732,3866,3260,606,Tuesday,1
5402,3759,3134,625,Wednesday,1
5069,3597,2984,613,Thursday,1
4222,2923,2364,559,Friday,0
2864,1902,1596,306,Saturday,0
3598,2447,2044,403,Sunday,0
5366,3767,3146,621,Monday,1
5427,3757,3124,633,Tuesday,1
5667,3759,3130,629,Wednesday,1
5517,3763,3069,694,Thursday,1
4420,2943,2429,514,Friday,0
3150,2274,1911,363,Saturday,0
4264,2962,2470,492,Sunday,0
6569,4276,3566,710,Monday,1
6145,4092,3391,701,Tuesday,1
5743,3932,3236,696,Wednesday,1
5512,3762,3075,687,Thursday,1
4127,2952,2377,575,Friday,0
3309,2195,1809,386,Saturday,0
3761,2669,2217,452,Sunday,0
5592,3912,3226,686,Monday,1
6100,4322,3575,747,Tuesday,1
6208,4265,3543,722,Wednesday,1
5730,4071,3352,719,Thursday,1
4372,3073,2508,565,Friday,0
3378,2259,1871,388,Saturday,0
4367,3012,2524,488,Sunday,0
6318,4424,3678,746,Monday,1
6431,4304,3530,774,Tuesday,1
5919,4205,3442,763,Wednesday,1
5668,3966,3266,700,Thursday,1
4581,3178,2594,584,Friday,0
3383,2263,1878,385,Saturday,0
4311,3005,2476,529,Sunday,0
6357,4214,3443,771,Monday,1
6092,4092,3343,749,Tuesday,1
5772,4070,3340,730,Wednesday,1
5861,4064,3330,734,Thursday,1
4600,3147,2590,557,Friday,0
3390,2218,1849,369,Saturday,0
4099,2898,2397,501,Sunday,0
6240,4320,3599,721,Monday,1
5871,4127,3375,752,Tuesday,1
6381,4506,3726,780,Wednesday,1
5853,4043,3328,715,Thursday,1
4425,3116,2499,617,Friday,0
2961,2099,1685,414,Saturday,0
4008,2744,2258,486,Sunday,0
5830,4040,3319,721,Monday,1
6089,4164,3448,716,Tuesday,1
5800,3946,3192,754,Wednesday,1
5431,3761,3100,661,Thursday,1
4560,3071,2543,528,Friday,0
3256,2254,1859,395,Saturday,0
4156,2858,2386,472,Sunday,0
6060,4232,3469,763,Monday,1
6191,4344,3578,766,Tuesday,1
6678,4612,3842,770,Wednesday,1
6167,4086,3361,725,Thursday,1
4441,3147,2601,546,Friday,0
3243,2325,1949,376,Saturday,0
4260,3039,2543,496,Sunday,0
6078,4238,3550,688,Monday,1
6824,4656,3833,823,Tuesday,1
6621,4727,3942,785,Wednesday,1
6231,4343,3647,696,Thursday,1
4776,3346,2719,627,Friday,0
3148,2319,1924,395,Saturday,0
4357,3050,2511,539,Sunday,0
6794,4738,3960,778,Monday,1
6688,4505,3736,769,Tuesday,1
6570,4448,3646,802,Wednesday,1
6113,4264,3504,760,Thursday,1
4856,3336,2726,610,Friday,0
3401,2409,2011,398,Saturday,0
4551,3197,2600,597,Sunday,0
6614,4773,3967,806,Monday,1
7019,4837,4037,800,Tuesday,1
6643,4470,3681,789,Wednesday,1
5398,3825,3133,692,Thursday,1
4323,2981,2482,499,Friday,0
3546,2442,2020,422,Saturday,0
4312,3045,2534,511,Sunday,0
6363,4520,3729,791,Monday,1
6797,4968,4147,821,Tuesday,1
7144,5002,4136,866,Wednesday,1
6555,4621,3804,817,Thursday,1
5400,3780,3089,691,Friday,0
3710,2465,2038,427,Saturday,0
4788,3294,2728,566,Sunday,0
6232,4340,3578,762,Monday,1
6093,4264,3440,824,Tuesday,1
6117,4275,3556,719,Wednesday,1
6274,4153,3433,720,Thursday,1
4774,3370,2763,607,Friday,0
3437,2462,1999,463,Saturday,0
4330,3009,2457,552,Sunday,0
5902,4164,3402,762,Monday,1
6064,4258,3469,789,Tuesday,1
5709,4049,3310,739,Wednesday,1
5596,3944,3275,669,Thursday,1
4498,3144,2494,650,Friday,0
3258,2119,1702,417,Saturday,0
3571,2565,2070,495,Sunday,0
5677,3908,3136,772,Monday,1
5534,3669,2977,692,Tuesday,1
5391,3667,2989,678,Wednesday,1
5043,3577,2953,624,Thursday,1
3993,2795,2254,541,Friday,0
2565,1876,1545,331,Saturday,0
3369,2364,1954,410,Sunday,0
4993,3442,2806,636,Monday,1
4728,3406,2813,593,Tuesday,1
4963,3431,2772,659,Wednesday,1
4637,3243,2698,545,Thursday,1
3694,2559,2070,489,Friday,0
2460,1658,1347,311,Saturday,0
3006,2064,1693,371,Sunday,0
3992,2780,2271,509,Monday,1
4960,3403,2767,636,Tuesday,1
4376,3115,2562,553,Wednesday,1
4143,2896,2353,543,Thursday,1
3359,2363,1909,454,Friday,0
2218,1474,1221,253,Saturday,0
2768,1845,1516,329,Sunday,0
3967,2831,2295,536,Monday,1
4501,3008,2426,582,Tuesday,1
3973,2727,2233,494,Wednesday,1
4259,2871,2312,559,Thursday,1
3181,2313,1869,444,Friday,0
2170,1583,1324,259,Saturday,0
2810,1930,1586,344,Sunday,0
4420,3030,2463,567,Monday,1
4793,3258,2664,594,Tuesday,1
4410,3064,2479,585,Wednesday,1
4076,2844,2280,564,Thursday,1
3287,2265,1789,476,Friday,0
2176,1467,1201,266,Saturday,0
2516,1747,1419,328,Sunday,0
4142,2925,2398,527,Monday,1
4225,3013,2461,552,Tuesday,1
4162,2882,2351,531,Wednesday,1
3716,2615,2137,478,Thursday,1
3333,2275,1853,422,Friday,0
1918,1360,1118,242,Saturday,0
2344,1621,1317,304,Sunday,0
3691,2591,2149,442,Monday,1
4035,2770,2247,523,Tuesday,1
3939,2675,2186,489,Wednesday,1
3738,2671,2197,474,Thursday,1
2846,2021,1657,364,Friday,0
1733,1199,983,216,Saturday,0
2184,1494,1240,254,Sunday,0
3512,2485,2001,484,Monday,1
3675,2636,2163,473,Tuesday,1
3831,2579,2144,435,Wednesday,1
2801,1971,1648,323,Thursday,1
2552,1790,1446,344,Friday,0
1950,1291,1110,181,Saturday,0
2110,1477,1209,268,Sunday,0
4303,2903,2383,520,Monday,1
3883,2799,2335,464,Tuesday,1
4244,2907,2347,560,Wednesday,1
3765,2669,2150,519,Thursday,1
3286,2276,1816,460,Friday,0
1851,1305,1063,242,Saturday,0
2580,1754,1433,321,Sunday,0
4140,2911,2382,529,Monday,1
4076,2785,2285,500,Tuesday,1
4141,2900,2360,540,Wednesday,1
3898,2774,2249,525,Thursday,1
3027,2078,1641,437,Friday,0
1831,1271,1033,238,Saturday,0
2282,1617,1356,261,Sunday,0
4138,2890,2376,514,Monday,1
4049,2868,2344,524,Tuesday,1
4272,2963,2359,604,Wednesday,1
4089,2755,2210,545,Thursday,1
3277,2264,1842,422,Friday,0
1954,1308,1069,239,Saturday,0
2111,1509,1239,270,Sunday,0
3625,2539,2053,486,Monday,1
4415,2906,2386,520,Tuesday,1
3854,2743,2260,483,Wednesday,1
4114,2771,2262,509,Thursday,1
3492,2280,1874,406,Friday,0
1849,1312,1096,216,Saturday,0
2239,1630,1347,283,Sunday,0
3976,2664,2191,473,Monday,1
4061,2833,2284,549,Tuesday,1
3702,2675,2215,460,Wednesday,1
3622,2553,2112,441,Thursday,1
3039,2033,1660,373,Friday,0
1848,1265,1049,216,Saturday,0
2082,1502,1242,260,Sunday,0
3807,2574,2121,453,Monday,1
3993,2667,2215,452,Tuesday,1
3567,2517,2087,430,Wednesday,1
3484,2450,2046,404,Thursday,1
2994,2022,1663,359,Friday,0
1793,1276,1074,202,Saturday,0
2422,1721,1477,244,Sunday,0
4070,2847,2371,476,Monday,1
3987,2800,2293,507,Tuesday,1
3355,2407,1963,444,Wednesday,1
2925,1959,1627,332,Thursday,1
3010,2143,1769,374,Friday,0
1896,1380,1151,229,Saturday,0
2501,1791,1497,294,Sunday,0
3851,2714,2257,457,Monday,1
4403,3075,2622,453,Tuesday,1
4627,3125,2623,502,Wednesday,1
4221,2982,2477,505,Thursday,1
3025,2102,1727,375,Friday,0
1998,1386,1179,207,Saturday,0
2297,1645,1414,231,Sunday,0
3192,2272,1910,362,Monday,1
4087,2921,2434,487,Tuesday,1
4787,3348,2842,506,Wednesday,1
4483,3078,2570,508,Thursday,1
3571,2483,2095,388,Friday,0
2263,1566,1343,223,Saturday,0
2948,2118,1827,291,Sunday,0
4521,3287,2785,502,Monday,1
4563,3251,2758,493,Tuesday,1
4598,3365,2901,464,Wednesday,1
4603,3356,2868,488,Thursday,1
3349,2508,2121,387,Friday,0
2437,1716,1451,265,Saturday,0
3188,2367,2082,285,Sunday,0
5291,3839,3280,559,Monday,1
5477,3815,3273,542,Tuesday,1
5257,3726,3222,504,Wednesday,1
5000,3500,3028,472,Thursday,1
3890,2822,2407,415,Friday,0
2654,1994,1739,255,Saturday,0
3656,2640,2328,312,Sunday,0
5223,3804,3291,513,Monday,1
5276,3826,3287,539,Tuesday,1
5476,3838,3306,532,Wednesday,1
5196,3718,3208,510,Thursday,1
4052,2863,2448,415,Friday,0
2635,1945,1696,249,Saturday,0
4076,2895,2541,354,Sunday,0
5167,3754,3216,538,Monday,1
4972,3634,3082,552,Tuesday,1
5143,3683,3209,474,Wednesday,1
4753,3454,2941,513,Thursday,1
3795,2854,2440,414,Friday,0
2920,2118,1827,291,Saturday,0
3950,2850,2471,379,Sunday,0
5493,3929,3432,497,Monday,1
5652,4186,3705,481,Tuesday,1
5617,3936,3388,548,Wednesday,1
5234,3802,3261,541,Thursday,1
4118,3147,2674,473,Friday,0
2863,2111,1803,308,Saturday,0
4032,3013,2645,368,Sunday,0
5476,4022,3466,556,Monday,1
5542,4117,3572,545,Tuesday,1
5340,3966,3403,563,Wednesday,1
5388,3905,3333,572,Thursday,1
4309,3097,2675,422,Friday,0
3117,2223,1897,326,Saturday,0
4234,3081,2679,402,Sunday,0
5698,4144,3507,637,Monday,1
5721,4132,3536,596,Tuesday,1
6018,4446,3823,623,Wednesday,1
5563,3995,3397,598,Thursday,1
4159,2961,2461,500,Friday,0
2732,2057,1753,304,Saturday,0
3901,2854,2460,394,Sunday,0
5749,4120,3529,591,Monday,1
5821,4140,3576,564,Tuesday,1
5647,4059,3452,607,Wednesday,1
5219,3689,3180,509,Thursday,1
4054,3010,2604,406,Friday,0
2815,2170,1889,281,Saturday,0
4253,3063,2603,460,Sunday,0
5816,4184,3640,544,Monday,1
5843,4176,3549,627,Tuesday,1
6058,4351,3672,679,Wednesday,1
6291,4489,3810,679,Thursday,1
4604,3357,2839,518,Friday,0
3354,2337,2000,337,Saturday,0
4190,3075,2634,441,Sunday,0
5931,4194,3573,621,Monday,1
6443,4589,3877,712,Tuesday,1
5805,4275,3572,703,Wednesday,1
5753,4172,3569,603,Thursday,1
4709,3452,2927,525,Friday,0
3418,2506,2136,370,Saturday,0
4821,3387,2872,515,Sunday,0
6444,4699,3985,714,Monday,1
6607,4772,4119,653,Tuesday,1
6726,4781,4115,666,Wednesday,1
6334,4462,3840,622,Thursday,1
4575,3214,2724,490,Friday,0
3414,2474,2118,356,Saturday,0
4535,3242,2787,455,Sunday,0
5970,4467,3836,631,Monday,1
5630,4115,3522,593,Tuesday,1
5384,3823,3225,598,Wednesday,1
4201,3223,2747,476,Thursday,1
3799,2947,2504,443,Friday,0
3301,2443,2053,390,Saturday,0
4420,3308,2849,459,Sunday,0
6384,4674,4031,643,Monday,1
6964,4975,4285,690,Tuesday,1
6957,4959,4252,707,Wednesday,1
6350,4671,3989,682,Thursday,1
5324,3796,3258,538,Friday,0
3795,2760,2362,398,Saturday,0
5013,3636,3159,477,Sunday,0
7005,5250,4569,681,Monday,1
6606,4791,4131,660,Tuesday,1
6686,4902,4240,662,Wednesday,1
6163,4533,3871,662,Thursday,1
4581,3272,2801,471,Friday,0
2930,2240,1958,282,Saturday,0
3585,2672,2280,392,Sunday,0
4925,3653,3128,525,Monday,1
4743,3441,2895,546,Tuesday,1
4716,3390,2918,472,Wednesday,1
3793,2821,2381,440,Thursday,1
2688,1906,1583,323,Friday,0
1682,1177,1020,157,Saturday,0
1880,1411,1190,221,Sunday,0
2451,1738,1442,296,Monday,1
1644,1197,977,220,Tuesday,1
1483,1027,851,176,Wednesday,1
1864,1355,1102,253,Thursday,1
1927,1319,1109,210,Friday,0
1679,1219,1019,200,Saturday,0
1962,1299,1111,188,Sunday,0
2469,1762,1479,283,Monday,1
1750,1192,1005,187,Tuesday,1
1554,1105,870,235,Wednesday,1
2820,2083,1754,329,Thursday,1
2970,2180,1859,321,Friday,0
2111,1526,1300,226,Saturday,0
2393,1788,1514,274,Sunday,0
3704,2770,2341,429,Monday,1
3760,2915,2492,423,Tuesday,1
3698,2844,2402,442,Wednesday,1
4243,3374,2910,464,Thursday,1
3177,2415,2043,372,Friday,0
2361,1834,1581,253,Saturday,0
2762,2238,1961,277,Sunday,0
4298,3242,2727,515,Monday,1
3838,2884,2450,434,Tuesday,1
3754,2864,2470,394,Wednesday,1
3817,2951,2510,441,Thursday,1
3175,2419,2006,413,Friday,0
2336,1927,1681,246,Saturday,0
2597,2031,1717,314,Sunday,0
3715,2948,2505,443,Monday,1
4459,3501,3017,484,Tuesday,1
4483,3552,3079,473,Wednesday,1
4225,3295,2805,490,Thursday,1
3111,2484,2131,353,Friday,0
2353,1784,1535,249,Saturday,0
3198,2520,2213,307,Sunday,0
4432,3539,3058,481,Monday,1
4664,3654,3148,506,Tuesday,1
4471,3544,3025,519,Wednesday,1
4486,3499,3031,468,Thursday,1
3527,2704,2304,400,Friday,0
2514,1995,1728,267,Saturday,0
2993,2409,2106,303,Sunday,0
4728,3694,3174,520,Monday,1
4883,3982,3472,510,Tuesday,1
5071,4061,3528,533,Wednesday,1
4638,3715,3217,498,Thursday,1
3757,2942,2512,430,Friday,0
2761,2193,1890,303,Saturday,0
3423,2849,2498,351,Sunday,0
5066,4016,3464,552,Monday,1
4928,4045,3499,546,Tuesday,1
4996,4019,3497,522,Wednesday,1
5004,3823,3188,635,Thursday,1
3675,2949,2529,420,Friday,0
2556,2024,1757,267,Saturday,0
3732,2808,2361,447,Sunday,0
4958,3951,3382,569,Monday,1
4869,3806,3273,533,Tuesday,1
5224,4042,3495,547,Wednesday,1
4890,3748,3212,536,Thursday,1
3678,2914,2528,386,Friday,0
2456,2025,1759,266,Saturday,0
3444,2708,2387,321,Sunday,0
5000,3974,3390,584,Monday,1
5496,4210,3601,609,Tuesday,1
5059,4014,3468,546,Wednesday,1
4813,3759,3247,512,Thursday,1
3810,3052,2569,483,Friday,0
2682,2169,1858,311,Saturday,0
3332,2754,2379,375,Sunday,0
4872,3801,3264,537,Monday,1
5097,3956,3452,504,Tuesday,1
4714,3591,3118,473,Wednesday,1
5048,3994,3428,566,Thursday,1
3698,2843,2386,457,Friday,0
2670,2095,1798,297,Saturday,0
3416,2743,2362,381,Sunday,0
4731,3830,3269,561,Monday,1
4820,3718,3169,549,Tuesday,1
4813,3711,3182,529,Wednesday,1
4393,3508,2952,556,Thursday,1
3316,2613,2172,441,Friday,0
2416,1888,1569,319,Saturday,0
2934,2251,1937,314,Sunday,0
2732,2157,1809,348,Monday,1
3805,3007,2525,482,Tuesday,1
3748,2976,2508,468,Wednesday,1
3678,2883,2471,412,Thursday,1
3322,2647,2239,408,Friday,0
2701,2049,1749,300,Saturday,0
3263,2469,2120,349,Sunday,0
4105,3166,2690,476,Monday,1
4156,3247,2766,481,Tuesday,1
4153,3367,2878,489,Wednesday,1
4256,3394,2944,450,Thursday,1
3818,3002,2588,414,Friday,0
3045,2438,2103,335,Saturday,0
4079,3047,2603,444,Sunday,0
4899,3852,3280,572,Monday,1
4943,3822,3310,512,Tuesday,1
4907,3799,3317,482,Wednesday,1
4933,3838,3305,533,Thursday,1
4665,3498,2975,523,Friday,0
3366,2536,2175,361,Saturday,0
3976,3045,2644,401,Sunday,0
4981,3921,3351,570,Monday,1
5331,4144,3552,592,Tuesday,1
5331,4203,3656,547,Wednesday,1
5063,3982,3426,556,Thursday,1
4252,3354,2869,485,Friday,0
3656,2712,2279,433,Saturday,0
4152,3125,2666,459,Sunday,0
5089,3922,3379,543,Monday,1
5491,4314,3721,593,Tuesday,1
5665,4424,3754,670,Wednesday,1
5423,4203,3592,611,Thursday,1
4688,3682,3146,536,Friday,0
4055,3007,2521,486,Saturday,0
4830,3671,3057,614,Sunday,0
5908,4517,3869,648,Monday,1
5633,4377,3722,655,Tuesday,1
5786,4520,3856,664,Wednesday,1
5967,4758,4074,684,Thursday,1
4937,3879,3319,560,Friday,0
4327,3284,2814,470,Saturday,0
5086,3964,3393,571,Sunday,0
6038,4771,4054,717,Monday,1
6324,4920,4210,710,Tuesday,1
6062,4735,4006,729,Wednesday,1
5520,4375,3776,599,Thursday,1
4670,3621,3068,553,Friday,0
4171,3145,2683,462,Saturday,0
4716,3648,3067,581,Sunday,0
5939,4567,3882,685,Monday,1
6361,4900,4169,731,Tuesday,1
6659,5322,4580,742,Wednesday,1
6264,4857,4067,790,Thursday,1
5359,4202,3592,610,Friday,0
4593,3452,2932,520,Saturday,0
5092,3917,3338,579,Sunday,0
6563,5112,4278,834,Monday,1
6124,4775,4028,747,Tuesday,1
5817,4596,3886,710,Wednesday,1
6057,4583,3937,646,Thursday,1
4958,3829,3183,646,Friday,0
3651,2827,2384,443,Saturday,0
4248,3291,2737,554,Sunday,0
5624,4231,3588,643,Monday,1
5595,4300,3666,634,Tuesday,1
5213,4106,3466,640,Wednesday,1
5156,3990,3372,618,Thursday,1
4350,3343,2816,527,Friday,0
3446,2696,2291,405,Saturday,0
3945,2969,2479,490,Sunday,0
4639,3610,3054,556,Monday,1
5224,4069,3416,653,Tuesday,1
5242,4105,3474,631,Wednesday,1
4939,3966,3371,595,Thursday,1
4387,3486,2949,537,Friday,0
3327,2583,2189,394,Saturday,0
3692,2919,2482,437,Sunday,0
4734,3707,3133,574,Monday,1
4727,3690,3057,633,Tuesday,1
4994,3869,3239,630,Wednesday,1
4767,3733,3156,577,Thursday,1
4124,3247,2778,469,Friday,0
3230,2425,2045,380,Saturday,0
3906,3049,2574,475,Sunday,0
4895,3787,3188,599,Monday,1
4871,3644,3050,594,Tuesday,1
4989,3857,3269,588,Wednesday,1
4633,3560,3015,545,Thursday,1
4475,3292,2757,535,Friday,0
2967,2304,1942,362,Saturday,0
3507,2684,2282,402,Sunday,0
4337,3348,2794,554,Monday,1
4470,3461,2964,497,Tuesday,1
4439,3450,2898,552,Wednesday,1
4895,3677,3132,545,Thursday,1
3924,2911,2459,452,Friday,0
2827,2190,1851,339,Saturday,0
3481,2668,2256,412,Sunday,0
4627,3493,2935,558,Monday,1
4561,3493,2950,543,Tuesday,1
4626,3521,2982,539,Wednesday,1
4137,3215,2668,547,Thursday,1
3555,2675,2248,427,Friday,0
2671,1999,1680,319,Saturday,0
3486,2635,2233,402,Sunday,0
4000,3119,2616,503,Monday,1
3828,3013,2553,460,Tuesday,1
3935,3049,2599,450,Wednesday,1
3633,2881,2397,484,Thursday,1
2997,2286,1932,354,Friday,0
2194,1704,1420,284,Saturday,0
2948,2198,1836,362,Sunday,0
4049,3215,2724,491,Monday,1
3792,2998,2485,513,Tuesday,1
4029,3096,2613,483,Wednesday,1
3945,3039,2587,452,Thursday,1
3523,2620,2173,447,Friday,0
2646,1981,1665,316,Saturday,0
3454,2611,2213,398,Sunday,0
3703,2916,2459,457,Monday,1
3680,2853,2397,456,Tuesday,1
3479,2627,2196,431,Wednesday,1
3756,2916,2463,453,Thursday,1
3289,2557,2122,435,Friday,0
2416,1892,1606,286,Saturday,0
2793,2197,1892,305,Sunday,0
3749,2881,2428,453,Monday,1
3786,2889,2450,439,Tuesday,1
4002,3039,2566,473,Wednesday,1
3823,3033,2525,508,Thursday,1
3430,2623,2262,361,Friday,0
2400,1767,1487,280,Saturday,0
2835,2207,1869,338,Sunday,0
4001,3031,2523,508,Monday,1
3795,2969,2525,444,Tuesday,1
3903,3010,2591,419,Wednesday,1
3397,2687,2265,422,Thursday,1
3005,2317,1887,430,Friday,0
2305,1750,1479,271,Saturday,0
2696,1993,1701,292,Sunday,0
3866,2814,2368,446,Monday,1
3826,2845,2400,445,Tuesday,1
3673,2774,2334,440,Wednesday,1
3660,2625,2189,436,Thursday,1
3136,2364,1941,423,Friday,0
2223,1628,1354,274,Saturday,0
2623,1941,1644,297,Sunday,0
3638,2745,2325,420,Monday,1
3740,2742,2258,484,Tuesday,1
3767,2904,2477,427,Wednesday,1
3621,2780,2322,458,Thursday,1
2971,2308,1922,386,Friday,0
2221,1696,1373,323,Saturday,0
2724,2037,1686,351,Sunday,0
3456,2638,2181,457,Monday,1
3581,2683,2184,499,Tuesday,1
2064,1564,1297,267,Wednesday,1
